C 133,193,233


EA ./texture_1.xpm
NO   ./texture_2.xpm

F 93,109,126

SO ./texture_3.xpm
WE ./texture_2.xpm

1111111111111111111111111
10E0000000000000000000001
1000011111111111111000001
1000010000000000001000001
1000010000010000001000001
1000011111001111111000001
1000000001000000000000001
1000000101111111111000001
1000000100000000001000001
1000000100000000001000001
1000000100000000001000001
1111111100000000001000001
1000000101000000001000001
1000000101000000001000001
1000000101000000001000001
1000000101000000001000001
1111111111111111111000001
1000000000000000000000001
1000000000000000000000001
1000000000000000000000001
1111111111111111111111111
1000000000000000000000001
1000000100000000000000001
1000000100000000000000001
1111111110000000000000001
1000000000000000000000001
1000000000000000000000001
1111111111111111111111111
